2,2,2,2,2,2,2,2,2,2,2
2,1,1,1,1,1,1,1,1,1,2
2,1,1,1,1,1,1,1,1,1,2
2,1,1,3,3,4,4,4,1,1,2
2,1,1,0,1,1,1,1,1,1,2
2,1,1,0,1,1,1,1,1,1,2
2,2,2,2,2,2,4,2,2,2,2